Levels: 4

w: 10, h: 3
##########
#P-*-=-@x#
##########

w: 9, h: 5
#########
##--=-@x#
#P-*#-@x#
##--=-@x#
#########

w: 7, h: 5
#######
#P-~--#
###@-##
###--##
#######

w: 7, h: 8
#######
#P->>>#
#---*-#
#=#@#-#
#-#---#
#x#@#v#
#x#---#
#######
