Levels: 6

w: 10, h: 3
##########
#P-----@x#
##########

w: 9, h: 4
#########
##----@x#
#P-##-@x#
#########

w: 9, h: 4
#########
##----###
#P-++-@x#
#########

w: 7, h: 5
#######
#-#####
#@--@x#
#P#####
#######

w: 6, h: 6
######
####x#
#P>#@#
#<v#^#
#v>>>#
######

w: 6, h: 5
######
#P@>x#
#---@#
###v>#
######