Levels: 5
MinLevelNotCompleted: 0

w: 10, h: 3
##########
#P-----@x#
##########

w: 9, h: 5
#########
#+@+@+@+#
#########
#P----@x#
#########

w: 9, h: 4
#########
##----@x#
#P-##-@x#
#########

w: 9, h: 4
#########
##----###
#P-++-@x#
#########

w: 6, h: 6
######
####x#
#P>#@#
#<v#^#
#v>>>#
######