Levels: 1

w: 18, h: 5
###############^##
<---#---#x@x@x@x-#
<---<-P-=--------#
<---#---#x@x@x@--@
###############^##
